abaft	𐑩𐑚𐑨𐑓𐑑
advance	𐑩𐑛𐑝𐑨𐑯𐑕
advanced	𐑩𐑛𐑝𐑨𐑯𐑕𐑑
advancement	𐑩𐑛𐑝𐑨𐑯𐑕𐑥𐑩𐑯𐑑
advances	𐑩𐑛𐑝𐑨𐑯𐑕𐑩𐑟
advancing	𐑩𐑛𐑝𐑨𐑯𐑕𐑦𐑙
advantage	𐑩𐑛𐑝𐑨𐑯𐑑𐑦𐑡
advantaged	𐑩𐑛𐑝𐑨𐑯𐑑𐑦𐑡𐑛
advantages	𐑩𐑛𐑝𐑨𐑯𐑑𐑦𐑡𐑩𐑟
advantaging	𐑩𐑛𐑝𐑨𐑯𐑑𐑦𐑡𐑦𐑙
afghanistan	𐑨𐑓𐑜𐑨𐑯𐑦𐑕𐑑𐑨𐑯
afghanistani	𐑨𐑓𐑜𐑨𐑯𐑦𐑕𐑑𐑨𐑯𐑦
afghanistanis	𐑨𐑓𐑜𐑨𐑯𐑦𐑕𐑑𐑨𐑯𐑦𐑟
aft	𐑨𐑓𐑑
after	𐑨𐑓𐑑𐑼
after-	𐑨𐑓𐑑𐑼-
aftercare	𐑨𐑓𐑑𐑼𐑒𐑺
afterdamp	𐑨𐑓𐑑𐑼𐑛𐑨𐑥𐑐
aftereffect	𐑨𐑓𐑑𐑼𐑦𐑓𐑧𐑒𐑑
aftereffects	𐑨𐑓𐑑𐑼𐑦𐑓𐑧𐑒𐑑𐑕
afterglow	𐑨𐑓𐑑𐑼𐑜𐑤𐑴
afterlife	𐑨𐑓𐑑𐑼𐑤𐑲𐑓
aftermath	𐑨𐑓𐑑𐑼𐑥𐑨𐑔
afternoon	𐑨𐑓𐑑𐑼𐑯𐑵𐑯
afternoons	𐑨𐑓𐑑𐑼𐑯𐑵𐑯𐑟
afters	𐑨𐑓𐑑𐑼𐑟
aftershock	𐑨𐑓𐑑𐑼𐑖𐑪𐑒
aftershocks	𐑨𐑓𐑑𐑼𐑖𐑪𐑒𐑕
afterthought	𐑨𐑓𐑑𐑼𐑔𐑷𐑑
afterthoughts	𐑨𐑓𐑑𐑼𐑔𐑷𐑑𐑕
afterward	𐑨𐑓𐑑𐑼𐑢𐑼𐑛
afterwards	𐑨𐑓𐑑𐑼𐑢𐑼𐑛𐑟
aghast	𐑩𐑜𐑨𐑕𐑑
air-shaft	𐑺-𐑖𐑨𐑓𐑑
air-shafts	𐑺-𐑖𐑨𐑓𐑑𐑕
aircraft	𐑺𐑒𐑮𐑨𐑓𐑑
aircraftman	𐑺𐑒𐑮𐑨𐑓𐑑𐑥𐑩𐑯
aircraftmen	𐑺𐑒𐑮𐑨𐑓𐑑𐑥𐑧𐑯
alexander	𐑨𐑤𐑦𐑜𐑟𐑨𐑯𐑛𐑼
alexandra	𐑨𐑤𐑦𐑜𐑟𐑨𐑯𐑛𐑮𐑩
alexandras	𐑨𐑤𐑦𐑜𐑟𐑨𐑯𐑛𐑮𐑩𐑟
alexandria	𐑨𐑤𐑦𐑜𐑟𐑨𐑯𐑛𐑮𐑾
amen	𐑨𐑥𐑧𐑯
answer	𐑨𐑯𐑕𐑼
answerable	𐑨𐑯𐑕𐑼𐑩𐑚𐑩𐑤
answered	𐑨𐑯𐑕𐑼𐑛
answering	𐑨𐑯𐑕𐑼𐑦𐑙
answers	𐑨𐑯𐑕𐑼𐑟
anti-aircraft	𐑨𐑯𐑑𐑦-𐑺𐑒𐑮𐑨𐑓𐑑
arty-crafty	𐑸𐑑𐑦-𐑒𐑮𐑨𐑓𐑑𐑦
ask	𐑨𐑕𐑒
asked	𐑨𐑕𐑒𐑑
asking	𐑨𐑕𐑒𐑦𐑙
asks	𐑨𐑕𐑒𐑕
aslant	𐑩𐑕𐑤𐑨𐑯𐑑
at last	𐑨𐑑 𐑤𐑨𐑕𐑑
aunt	𐑨𐑯𐑑
auntie	𐑨𐑯𐑑𐑦
aunties	𐑨𐑯𐑑𐑦𐑟
aunts	𐑨𐑯𐑑𐑕
aunty	𐑨𐑯𐑑𐑦
avalanche	𐑨𐑝𐑩𐑤𐑨𐑯𐑗
avalanches	𐑨𐑝𐑩𐑤𐑨𐑯𐑗𐑩𐑟
avast	𐑩𐑝𐑨𐑕𐑑
avocado	𐑨𐑝𐑩𐑒𐑨𐑛𐑴
avocados	𐑨𐑝𐑩𐑒𐑨𐑛𐑴𐑟
ballet-dancer	𐑚𐑨𐑤𐑱-𐑛𐑨𐑯𐑕𐑼
ballet-dancers	𐑚𐑨𐑤𐑱-𐑛𐑨𐑯𐑕𐑼𐑟
banal	𐑚𐑩𐑯𐑨𐑤
banana	𐑚𐑩𐑯𐑨𐑯𐑩
bananas	𐑚𐑩𐑯𐑨𐑯𐑩𐑟
bandmaster	𐑚𐑨𐑯𐑛𐑥𐑨𐑕𐑑𐑼
bandmasters	𐑚𐑨𐑯𐑛𐑥𐑨𐑕𐑑𐑼𐑟
bank-draft	𐑚𐑨𐑙𐑒-𐑛𐑮𐑨𐑓𐑑
bank-drafts	𐑚𐑨𐑙𐑒-𐑛𐑮𐑨𐑓𐑑𐑕
bask	𐑚𐑨𐑕𐑒
basked	𐑚𐑨𐑕𐑒𐑑
basket	𐑚𐑨𐑕𐑒𐑩𐑑
basketball	𐑚𐑨𐑕𐑒𐑩𐑑𐑚𐑷𐑤
basketballs	𐑚𐑨𐑕𐑒𐑩𐑑𐑚𐑷𐑤𐑟
basketry	𐑚𐑨𐑕𐑒𐑩𐑑𐑮𐑦
baskets	𐑚𐑨𐑕𐑒𐑩𐑑𐑕
basking	𐑚𐑨𐑕𐑒𐑦𐑙
basks	𐑚𐑨𐑕𐑒𐑕
bastard	𐑚𐑨𐑕𐑑𐑼𐑛
bastardies	𐑚𐑨𐑕𐑑𐑼𐑛𐑦𐑟
bastardise	𐑚𐑨𐑕𐑑𐑼𐑛𐑲𐑟
bastardised	𐑚𐑨𐑕𐑑𐑼𐑛𐑲𐑟𐑛
bastardises	𐑚𐑨𐑕𐑑𐑼𐑛𐑲𐑟𐑩𐑟
bastardising	𐑚𐑨𐑕𐑑𐑼𐑛𐑲𐑟𐑦𐑙
bastardize	𐑚𐑨𐑕𐑑𐑼𐑛𐑲𐑟
bastardized	𐑚𐑨𐑕𐑑𐑼𐑛𐑲𐑟𐑛
bastardizes	𐑚𐑨𐑕𐑑𐑼𐑛𐑲𐑟𐑩𐑟
bastardizing	𐑚𐑨𐑕𐑑𐑼𐑛𐑲𐑟𐑦𐑙
bastards	𐑚𐑨𐑕𐑑𐑼𐑛𐑟
bastardy	𐑚𐑨𐑕𐑑𐑼𐑛𐑦
bath	𐑚𐑨𐑔
bath-chair	𐑚𐑨𐑔-𐑗𐑺
bath-chairs	𐑚𐑨𐑔-𐑗𐑺𐑟
bathed	𐑚𐑨𐑔𐑑
bathgate	𐑚𐑨𐑔𐑜𐑱𐑑
bathing	𐑚𐑨𐑔𐑦𐑙
bathrobe	𐑚𐑨𐑔𐑮𐑴𐑚
bathrobes	𐑚𐑨𐑔𐑮𐑴𐑚𐑟
bathroom	𐑚𐑨𐑔𐑮𐑵𐑥
bathrooms	𐑚𐑨𐑔𐑮𐑵𐑥𐑟
baths_NNS	𐑚𐑨𐑞𐑟
baths_VBZ	𐑚𐑨𐑔𐑕
bathtub	𐑚𐑨𐑔𐑑𐑳𐑚
bathtubs	𐑚𐑨𐑔𐑑𐑳𐑚𐑟
behalf	𐑚𐑦𐑣𐑨𐑓
behalves	𐑚𐑦𐑣𐑨𐑝𐑟
bellylaugh	𐑚𐑧𐑤𐑦𐑤𐑨𐑓
bellylaughed	𐑚𐑧𐑤𐑦𐑤𐑨𐑓𐑑
bellylaughing	𐑚𐑧𐑤𐑦𐑤𐑨𐑓𐑦𐑙
bellylaughs	𐑚𐑧𐑤𐑦𐑤𐑨𐑓𐑕
blanch	𐑚𐑤𐑨𐑯𐑗
blanched	𐑚𐑤𐑨𐑯𐑗𐑑
blanches	𐑚𐑤𐑨𐑯𐑗𐑩𐑟
blanching	𐑚𐑤𐑨𐑯𐑗𐑦𐑙
blast	𐑚𐑤𐑨𐑕𐑑
blast-furnace	𐑚𐑤𐑨𐑕𐑑-𐑓𐑻𐑯𐑦𐑕
blast-furnaces	𐑚𐑤𐑨𐑕𐑑-𐑓𐑻𐑯𐑦𐑕𐑩𐑟
blast-off	𐑚𐑤𐑨𐑕𐑑-𐑪𐑓
blast-offs	𐑚𐑤𐑨𐑕𐑑-𐑪𐑓𐑕
blasted	𐑚𐑤𐑨𐑕𐑑𐑩𐑛
blasting	𐑚𐑤𐑨𐑕𐑑𐑦𐑙
blasts	𐑚𐑤𐑨𐑕𐑑𐑕
blood-bath	𐑚𐑤𐑳𐑛-𐑚𐑨𐑔
blood-baths	𐑚𐑤𐑳𐑛-𐑚𐑨𐑞𐑟
bloodbath	𐑚𐑤𐑳𐑛𐑚𐑨𐑔
bloodbaths	𐑚𐑤𐑳𐑛𐑚𐑨𐑞𐑟
branch	𐑚𐑮𐑨𐑯𐑗
branched	𐑚𐑮𐑨𐑯𐑗𐑑
branches	𐑚𐑮𐑨𐑯𐑗𐑩𐑟
branchier	𐑚𐑮𐑨𐑯𐑗𐑦𐑼
branchiest	𐑚𐑮𐑨𐑯𐑗𐑦𐑩𐑕𐑑
branching	𐑚𐑮𐑨𐑯𐑗𐑦𐑙
branchy	𐑚𐑮𐑨𐑯𐑗𐑦
brass	𐑚𐑮𐑨𐑕
brasses	𐑚𐑮𐑨𐑕𐑩𐑟
brassier	𐑚𐑮𐑨𐑕𐑦𐑼
brassiest	𐑚𐑮𐑨𐑕𐑦𐑩𐑕𐑑
brassy	𐑚𐑮𐑨𐑕𐑦
bridle-path	𐑚𐑮𐑲𐑛𐑩𐑤-𐑐𐑨𐑔
bridle-paths	𐑚𐑮𐑲𐑛𐑩𐑤-𐑐𐑨𐑞𐑟
broadcast	𐑚𐑮𐑷𐑛𐑒𐑨𐑕𐑑
broadcasted	𐑚𐑮𐑷𐑛𐑒𐑨𐑕𐑑𐑩𐑛
broadcaster	𐑚𐑮𐑷𐑛𐑒𐑨𐑕𐑑𐑼
broadcasters	𐑚𐑮𐑷𐑛𐑒𐑨𐑕𐑑𐑼𐑟
broadcasting	𐑚𐑮𐑷𐑛𐑒𐑨𐑕𐑑𐑦𐑙
broadcasts	𐑚𐑮𐑷𐑛𐑒𐑨𐑕𐑑𐑕
burgomaster	𐑚𐑻𐑜𐑴𐑥𐑨𐑕𐑑𐑼
burgomasters	𐑚𐑻𐑜𐑴𐑥𐑨𐑕𐑑𐑼𐑟
bypass	𐑚𐑲𐑐𐑨𐑕
bypassed	𐑚𐑲𐑐𐑨𐑕𐑑
bypasses	𐑚𐑲𐑐𐑨𐑕𐑩𐑟
bypassing	𐑚𐑲𐑐𐑨𐑕𐑦𐑙
bypath	𐑚𐑲𐑐𐑨𐑔
bypaths	𐑚𐑲𐑐𐑨𐑞𐑟
cadre	𐑒𐑨𐑛𐑮𐑩
cadres	𐑒𐑨𐑛𐑮𐑩𐑟
calf	𐑒𐑨𐑓
calf-love	𐑒𐑨𐑓-𐑤𐑳𐑝
calve	𐑒𐑨𐑝
calved	𐑒𐑨𐑝𐑛
calves	𐑒𐑨𐑝𐑟
calving	𐑒𐑨𐑝𐑦𐑙
camshaft	𐑒𐑨𐑥𐑖𐑨𐑓𐑑
camshafts	𐑒𐑨𐑥𐑖𐑨𐑓𐑑𐑕
can't	𐑒𐑨𐑯𐑑
cask	𐑒𐑨𐑕𐑒
casket	𐑒𐑨𐑕𐑒𐑩𐑑
caskets	𐑒𐑨𐑕𐑒𐑩𐑑𐑕
casks	𐑒𐑨𐑕𐑒𐑕
cast	𐑒𐑨𐑕𐑑
cast-iron	𐑒𐑨𐑕𐑑-𐑲𐑼𐑯
cast-off	𐑒𐑨𐑕𐑑-𐑪𐑓
cast-offs	𐑒𐑨𐑕𐑑-𐑪𐑓𐑕
castaway	𐑒𐑨𐑕𐑑𐑩𐑢𐑱
castaways	𐑒𐑨𐑕𐑑𐑩𐑢𐑱𐑟
caste	𐑒𐑨𐑕𐑑
caster	𐑒𐑨𐑕𐑑𐑼
casters	𐑒𐑨𐑕𐑑𐑼𐑟
castes	𐑒𐑨𐑕𐑑𐑕
casting	𐑒𐑨𐑕𐑑𐑦𐑙
castings	𐑒𐑨𐑕𐑑𐑦𐑙𐑟
castle	𐑒𐑨𐑕𐑩𐑤
castled	𐑒𐑨𐑕𐑩𐑤𐑛
castleford	𐑒𐑨𐑕𐑩𐑤𐑓𐑼𐑛
castles	𐑒𐑨𐑕𐑩𐑤𐑟
castling	𐑒𐑨𐑕𐑤𐑦𐑙
castor	𐑒𐑨𐑕𐑑𐑼
castor oil	𐑒𐑨𐑕𐑑𐑼 𐑶𐑤
castors	𐑒𐑨𐑕𐑑𐑼𐑟
casts	𐑒𐑨𐑕𐑑𐑕
cenotaph	𐑕𐑧𐑯𐑩𐑑𐑨𐑓
cenotaphs	𐑕𐑧𐑯𐑩𐑑𐑨𐑓𐑕
chance	𐑗𐑨𐑯𐑕
chanced	𐑗𐑨𐑯𐑕𐑑
chancel	𐑗𐑨𐑯𐑕𐑩𐑤
chancelleries	𐑗𐑨𐑯𐑕𐑩𐑤𐑼𐑦𐑟
chancellery	𐑗𐑨𐑯𐑕𐑩𐑤𐑼𐑦
chancellor	𐑗𐑨𐑯𐑕𐑩𐑤𐑼
chancellors	𐑗𐑨𐑯𐑕𐑩𐑤𐑼𐑟
chancels	𐑗𐑨𐑯𐑕𐑩𐑤𐑟
chanceries	𐑗𐑨𐑯𐑕𐑼𐑦𐑟
chancery	𐑗𐑨𐑯𐑕𐑼𐑦
chances	𐑗𐑨𐑯𐑕𐑩𐑟
chancing	𐑗𐑨𐑯𐑕𐑦𐑙
chancy	𐑗𐑨𐑯𐑕𐑦
chandler	𐑗𐑨𐑯𐑛𐑤𐑼
chandlers	𐑗𐑨𐑯𐑛𐑤𐑼𐑟
chant	𐑗𐑨𐑯𐑑
chanted	𐑗𐑨𐑯𐑑𐑩𐑛
chanting	𐑗𐑨𐑯𐑑𐑦𐑙
chants	𐑗𐑨𐑯𐑑𐑕
charade	𐑖𐑼𐑨𐑛
chorale	𐑒𐑼𐑨𐑤
chorales	𐑒𐑼𐑨𐑤𐑟
clasp	𐑒𐑤𐑨𐑕𐑐
clasp-knife	𐑒𐑤𐑨𐑕𐑐-𐑯𐑲𐑓
clasp-knives	𐑒𐑤𐑨𐑕𐑐-𐑯𐑲𐑝𐑟
clasped	𐑒𐑤𐑨𐑕𐑐𐑑
clasping	𐑒𐑤𐑨𐑕𐑐𐑦𐑙
clasps	𐑒𐑤𐑨𐑕𐑐𐑕
class	𐑒𐑤𐑨𐑕
class-conscious	𐑒𐑤𐑨𐑕-𐑒𐑪𐑯𐑖𐑩𐑕
class-feeling	𐑒𐑤𐑨𐑕-𐑓𐑰𐑤𐑦𐑙
class-fellow	𐑒𐑤𐑨𐑕-𐑓𐑧𐑤𐑴
class-fellows	𐑒𐑤𐑨𐑕-𐑓𐑧𐑤𐑴𐑟
class-list	𐑒𐑤𐑨𐑕-𐑤𐑦𐑕𐑑
class-lists	𐑒𐑤𐑨𐑕-𐑤𐑦𐑕𐑑𐑕
class-warfare	𐑒𐑤𐑨𐑕-𐑢𐑹𐑓𐑺
classed	𐑒𐑤𐑨𐑕𐑑
classes	𐑒𐑤𐑨𐑕𐑩𐑟
classier	𐑒𐑤𐑨𐑕𐑦𐑼
classiest	𐑒𐑤𐑨𐑕𐑦𐑩𐑕𐑑
classing	𐑒𐑤𐑨𐑕𐑦𐑙
classless	𐑒𐑤𐑨𐑕𐑤𐑩𐑕
classmate	𐑒𐑤𐑨𐑕𐑥𐑱𐑑
classmates	𐑒𐑤𐑨𐑕𐑥𐑱𐑑𐑕
classroom	𐑒𐑤𐑨𐑕𐑮𐑵𐑥
classrooms	𐑒𐑤𐑨𐑕𐑮𐑵𐑥𐑟
classy	𐑒𐑤𐑨𐑕𐑦
clog-dance	𐑒𐑤𐑪𐑜-𐑛𐑨𐑯𐑕
clog-dances	𐑒𐑤𐑪𐑜-𐑛𐑨𐑯𐑕𐑩𐑟
clothes-basket	𐑒𐑤𐑴𐑞𐑟-𐑚𐑨𐑕𐑒𐑩𐑑
clothes-baskets	𐑒𐑤𐑴𐑞𐑟-𐑚𐑨𐑕𐑒𐑩𐑑𐑕
command	𐑒𐑩𐑥𐑨𐑯𐑛
commanded	𐑒𐑩𐑥𐑨𐑯𐑛𐑩𐑛
commander	𐑒𐑩𐑥𐑨𐑯𐑛𐑼
commanders	𐑒𐑩𐑥𐑨𐑯𐑛𐑼𐑟
commanding	𐑒𐑩𐑥𐑨𐑯𐑛𐑦𐑙
commandment	𐑒𐑩𐑥𐑨𐑯𐑛𐑥𐑩𐑯𐑑
commandments	𐑒𐑩𐑥𐑨𐑯𐑛𐑥𐑩𐑯𐑑𐑕
commando	𐑒𐑩𐑥𐑨𐑯𐑛𐑴
commandoes	𐑒𐑩𐑥𐑨𐑯𐑛𐑴𐑟
commandos	𐑒𐑩𐑥𐑨𐑯𐑛𐑴𐑟
commands	𐑒𐑩𐑥𐑨𐑯𐑛𐑟
contrast_NN	𐑒𐑪𐑯𐑑𐑮𐑨𐑕𐑑
contrast_VB	𐑒𐑩𐑯𐑑𐑮𐑨𐑕𐑑
contrasted	𐑒𐑩𐑯𐑑𐑮𐑨𐑕𐑑𐑩𐑛
contrasting	𐑒𐑩𐑯𐑑𐑮𐑨𐑕𐑑𐑦𐑙
contrastingly	𐑒𐑩𐑯𐑑𐑮𐑨𐑕𐑑𐑦𐑙𐑤𐑦
contrasts_NNS	𐑒𐑪𐑯𐑑𐑮𐑨𐑕𐑑𐑕
contrasts_VBZ	𐑒𐑩𐑯𐑑𐑮𐑨𐑕𐑑𐑕
corral	𐑒𐑼𐑨𐑤
corralled	𐑒𐑼𐑨𐑤𐑛
corralling	𐑒𐑼𐑨𐑤𐑦𐑙
corrals	𐑒𐑼𐑨𐑤𐑟
cotton-plant	𐑒𐑪𐑑𐑩𐑯-𐑐𐑤𐑨𐑯𐑑
cotton-plants	𐑒𐑪𐑑𐑩𐑯-𐑐𐑤𐑨𐑯𐑑𐑕
couch-grass	𐑒𐑬𐑗-𐑜𐑮𐑨𐑕
counter-example	𐑒𐑬𐑯𐑑𐑼-𐑦𐑜𐑟𐑨𐑥𐑐𐑩𐑤
counter-examples	𐑒𐑬𐑯𐑑𐑼-𐑦𐑜𐑟𐑨𐑥𐑐𐑩𐑤𐑟
counterblast	𐑒𐑬𐑯𐑑𐑼𐑚𐑤𐑨𐑕𐑑
counterblasts	𐑒𐑬𐑯𐑑𐑼𐑚𐑤𐑨𐑕𐑑𐑕
countermand	𐑒𐑬𐑯𐑑𐑼𐑥𐑨𐑯𐑛
countermanded	𐑒𐑬𐑯𐑑𐑼𐑥𐑨𐑯𐑛𐑩𐑛
countermanding	𐑒𐑬𐑯𐑑𐑼𐑥𐑨𐑯𐑛𐑦𐑙
countermands	𐑒𐑬𐑯𐑑𐑼𐑥𐑨𐑯𐑛𐑟
craft	𐑒𐑮𐑨𐑓𐑑
craftier	𐑒𐑮𐑨𐑓𐑑𐑦𐑼
craftiest	𐑒𐑮𐑨𐑓𐑑𐑦𐑩𐑕𐑑
craftily	𐑒𐑮𐑨𐑓𐑑𐑦𐑤𐑦
craftiness	𐑒𐑮𐑨𐑓𐑑𐑦𐑯𐑩𐑕
crafts	𐑒𐑮𐑨𐑓𐑑𐑕
craftsman	𐑒𐑮𐑨𐑓𐑑𐑕𐑥𐑩𐑯
craftsmanship	𐑒𐑮𐑨𐑓𐑑𐑕𐑥𐑩𐑯𐑖𐑦𐑐
craftsmen	𐑒𐑮𐑨𐑓𐑑𐑕𐑥𐑧𐑯
crafty	𐑒𐑮𐑨𐑓𐑑𐑦
crankshaft	𐑒𐑮𐑨𐑙𐑒𐑖𐑨𐑓𐑑
crankshafts	𐑒𐑮𐑨𐑙𐑒𐑖𐑨𐑓𐑑𐑕
daft	𐑛𐑨𐑓𐑑
dafter	𐑛𐑨𐑓𐑑𐑼
daftest	𐑛𐑨𐑓𐑑𐑩𐑕𐑑
daftly	𐑛𐑨𐑓𐑑𐑤𐑦
dance	𐑛𐑨𐑯𐑕
dance-band	𐑛𐑨𐑯𐑕-𐑚𐑨𐑯𐑛
dance-bands	𐑛𐑨𐑯𐑕-𐑚𐑨𐑯𐑛𐑟
dance-hall	𐑛𐑨𐑯𐑕-𐑣𐑷𐑤
dance-halls	𐑛𐑨𐑯𐑕-𐑣𐑷𐑤𐑟
dance-orchestra	𐑛𐑨𐑯𐑕-𐑹𐑒𐑦𐑕𐑑𐑮𐑩
dance-orchestras	𐑛𐑨𐑯𐑕-𐑹𐑒𐑦𐑕𐑑𐑮𐑩𐑟
danced	𐑛𐑨𐑯𐑕𐑑
dancefloor	𐑛𐑨𐑯𐑕𐑓𐑤𐑹
dancer	𐑛𐑨𐑯𐑕𐑼
dancers	𐑛𐑨𐑯𐑕𐑼𐑟
dances	𐑛𐑨𐑯𐑕𐑩𐑟
dancing	𐑛𐑨𐑯𐑕𐑦𐑙
death-mask	𐑛𐑧𐑔-𐑥𐑨𐑕𐑒
death-masks	𐑛𐑧𐑔-𐑥𐑨𐑕𐑒𐑕
demand	𐑛𐑦𐑥𐑨𐑯𐑛
demanded	𐑛𐑦𐑥𐑨𐑯𐑛𐑩𐑛
demanding	𐑛𐑦𐑥𐑨𐑯𐑛𐑦𐑙
demands	𐑛𐑦𐑥𐑨𐑯𐑛𐑟
die-cast	𐑛𐑲-𐑒𐑨𐑕𐑑
diorama	𐑛𐑲𐑼𐑨𐑥𐑩
dioramas	𐑛𐑲𐑼𐑨𐑥𐑩𐑟
disadvantage	𐑛𐑦𐑕𐑩𐑛𐑝𐑨𐑯𐑑𐑦𐑡
disadvantaged	𐑛𐑦𐑕𐑩𐑛𐑝𐑨𐑯𐑑𐑦𐑡𐑛
disadvantages	𐑛𐑦𐑕𐑩𐑛𐑝𐑨𐑯𐑑𐑦𐑡𐑩𐑟
disaster	𐑛𐑦𐑟𐑨𐑕𐑑𐑼
disasters	𐑛𐑦𐑟𐑨𐑕𐑑𐑼𐑟
disastrous	𐑛𐑦𐑟𐑨𐑕𐑑𐑮𐑩𐑕
disastrously	𐑛𐑦𐑟𐑨𐑕𐑑𐑮𐑩𐑕𐑤𐑦
disenchant	𐑛𐑦𐑕𐑦𐑯𐑗𐑨𐑯𐑑
disenchanted	𐑛𐑦𐑕𐑦𐑯𐑗𐑨𐑯𐑑𐑩𐑛
disenchanting	𐑛𐑦𐑕𐑦𐑯𐑗𐑨𐑯𐑑𐑦𐑙
disenchantment	𐑛𐑦𐑕𐑦𐑯𐑗𐑨𐑯𐑑𐑥𐑩𐑯𐑑
disenchantments	𐑛𐑦𐑕𐑦𐑯𐑗𐑨𐑯𐑑𐑥𐑩𐑯𐑑𐑕
disenchants	𐑛𐑦𐑕𐑦𐑯𐑗𐑨𐑯𐑑𐑕
distaff	𐑛𐑦𐑕𐑑𐑨𐑓
distaffs	𐑛𐑦𐑕𐑑𐑨𐑓𐑕
downcast	𐑛𐑬𐑯𐑒𐑨𐑕𐑑
draft	𐑛𐑮𐑨𐑓𐑑
drafted	𐑛𐑮𐑨𐑓𐑑𐑩𐑛
draftee	𐑛𐑮𐑨𐑓𐑑𐑰
draftees	𐑛𐑮𐑨𐑓𐑑𐑰𐑟
drafting	𐑛𐑮𐑨𐑓𐑑𐑦𐑙
draftings	𐑛𐑮𐑨𐑓𐑑𐑦𐑙𐑟
drafts	𐑛𐑮𐑨𐑓𐑑𐑕
draftsman	𐑛𐑮𐑨𐑓𐑑𐑕𐑥𐑩𐑯
draftsmen	𐑛𐑮𐑨𐑓𐑑𐑕𐑥𐑧𐑯
drama	𐑛𐑮𐑨𐑥𐑩
dramas	𐑛𐑮𐑨𐑥𐑩𐑟
draught	𐑛𐑮𐑨𐑓𐑑
draught-horse	𐑛𐑮𐑨𐑓𐑑-𐑣𐑹𐑕
draught-horses	𐑛𐑮𐑨𐑓𐑑-𐑣𐑹𐑕𐑩𐑟
draughted	𐑛𐑮𐑨𐑓𐑑𐑩𐑛
draughtier	𐑛𐑮𐑨𐑓𐑑𐑦𐑼
draughtiest	𐑛𐑮𐑨𐑓𐑑𐑦𐑩𐑕𐑑
draughting	𐑛𐑮𐑨𐑓𐑑𐑦𐑙
draughts	𐑛𐑮𐑨𐑓𐑑𐑕
draughtsman	𐑛𐑮𐑨𐑓𐑑𐑕𐑥𐑩𐑯
draughtsmen	𐑛𐑮𐑨𐑓𐑑𐑕𐑥𐑧𐑯
draughty	𐑛𐑮𐑨𐑓𐑑𐑦
eggplant	𐑧𐑜𐑐𐑤𐑨𐑯𐑑
eggplants	𐑧𐑜𐑐𐑤𐑨𐑯𐑑𐑕
elastoplast	𐑦𐑤𐑨𐑕𐑑𐑩𐑐𐑤𐑨𐑕𐑑
enchant	𐑦𐑯𐑗𐑨𐑯𐑑
enchanted	𐑦𐑯𐑗𐑨𐑯𐑑𐑩𐑛
enchanter	𐑦𐑯𐑗𐑨𐑯𐑑𐑼
enchanters	𐑦𐑯𐑗𐑨𐑯𐑑𐑼𐑟
enchanting	𐑦𐑯𐑗𐑨𐑯𐑑𐑦𐑙
enchantingly	𐑦𐑯𐑗𐑨𐑯𐑑𐑦𐑙𐑤𐑦
enchantment	𐑦𐑯𐑗𐑨𐑯𐑑𐑥𐑩𐑯𐑑
enchantments	𐑦𐑯𐑗𐑨𐑯𐑑𐑥𐑩𐑯𐑑𐑕
enchantress	𐑦𐑯𐑗𐑨𐑯𐑑𐑮𐑩𐑕
enchantresses	𐑦𐑯𐑗𐑨𐑯𐑑𐑮𐑩𐑕𐑩𐑟
enchants	𐑦𐑯𐑗𐑨𐑯𐑑𐑕
engraft	𐑦𐑯𐑜𐑮𐑨𐑓𐑑
engrafted	𐑦𐑯𐑜𐑮𐑨𐑓𐑑𐑩𐑛
engrafting	𐑦𐑯𐑜𐑮𐑨𐑓𐑑𐑦𐑙
engrafts	𐑦𐑯𐑜𐑮𐑨𐑓𐑑𐑕
enhance	𐑦𐑯𐑣𐑨𐑯𐑕
enhanced	𐑦𐑯𐑣𐑨𐑯𐑕𐑑
enhancement	𐑦𐑯𐑣𐑨𐑯𐑕𐑥𐑩𐑯𐑑
enhancements	𐑦𐑯𐑣𐑨𐑯𐑕𐑥𐑩𐑯𐑑𐑕
enhances	𐑦𐑯𐑣𐑨𐑯𐑕𐑩𐑟
enhancing	𐑦𐑯𐑣𐑨𐑯𐑕𐑦𐑙
entrance	𐑦𐑯𐑑𐑮𐑨𐑯𐑕
entranced	𐑦𐑯𐑑𐑮𐑨𐑯𐑕𐑑
entrances	𐑦𐑯𐑑𐑮𐑨𐑯𐑕𐑩𐑟
entrancing	𐑦𐑯𐑑𐑮𐑨𐑯𐑕𐑦𐑙
entrancingly	𐑦𐑯𐑑𐑮𐑨𐑯𐑕𐑦𐑙𐑤𐑦
epitaph	𐑧𐑐𐑦𐑑𐑨𐑓
epitaphs	𐑧𐑐𐑦𐑑𐑨𐑓𐑕
errata	𐑧𐑮𐑨𐑑𐑩
erratum	𐑧𐑮𐑨𐑑𐑩𐑥
esperanto	𐑧𐑕𐑐𐑼𐑨𐑯𐑑𐑴
everlasting	𐑧𐑝𐑼𐑤𐑨𐑕𐑑𐑦𐑙
everlastingly	𐑧𐑝𐑼𐑤𐑨𐑕𐑑𐑦𐑙𐑤𐑦
example	𐑦𐑜𐑟𐑨𐑥𐑐𐑩𐑤
examples	𐑦𐑜𐑟𐑨𐑥𐑐𐑩𐑤𐑟
eyebath	𐑲𐑚𐑨𐑔
eyebaths	𐑲𐑚𐑨𐑞𐑟
eyeglass	𐑲𐑜𐑤𐑨𐑕
eyeglasses	𐑲𐑜𐑤𐑨𐑕𐑩𐑟
fast	𐑓𐑨𐑕𐑑
fasted	𐑓𐑨𐑕𐑑𐑩𐑛
fasten	𐑓𐑨𐑕𐑩𐑯
fastened	𐑓𐑨𐑕𐑩𐑯𐑛
fastener	𐑓𐑨𐑕𐑩𐑯𐑼
fasteners	𐑓𐑨𐑕𐑩𐑯𐑼𐑟
fastening	𐑓𐑨𐑕𐑩𐑯𐑦𐑙
fastenings	𐑓𐑨𐑕𐑩𐑯𐑦𐑙𐑟
fastens	𐑓𐑨𐑕𐑩𐑯𐑟
faster	𐑓𐑨𐑕𐑑𐑼
fastest	𐑓𐑨𐑕𐑑𐑩𐑕𐑑
fasting	𐑓𐑨𐑕𐑑𐑦𐑙
fastness	𐑓𐑨𐑕𐑑𐑯𐑩𐑕
fastnesses	𐑓𐑨𐑕𐑑𐑯𐑩𐑕𐑩𐑟
fasts	𐑓𐑨𐑕𐑑𐑕
fibreglass	𐑓𐑲𐑚𐑼𐑜𐑤𐑨𐑕
finale	𐑓𐑦𐑯𐑨𐑤𐑦
finales	𐑓𐑦𐑯𐑨𐑤𐑦𐑟
first-class	𐑓𐑻𐑕𐑑-𐑒𐑤𐑨𐑕
flabbergast	𐑓𐑤𐑨𐑚𐑼𐑜𐑨𐑕𐑑
flabbergasted	𐑓𐑤𐑨𐑚𐑼𐑜𐑨𐑕𐑑𐑩𐑛
flabbergasting	𐑓𐑤𐑨𐑚𐑼𐑜𐑨𐑕𐑑𐑦𐑙
flabbergasts	𐑓𐑤𐑨𐑚𐑼𐑜𐑨𐑕𐑑𐑕
flagstaff	𐑓𐑤𐑨𐑜𐑕𐑑𐑨𐑓
flagstaffs	𐑓𐑤𐑨𐑜𐑕𐑑𐑨𐑓𐑕
flare-path	𐑓𐑤𐑺-𐑐𐑨𐑔
flare-paths	𐑓𐑤𐑺-𐑐𐑨𐑞𐑟
flask	𐑓𐑤𐑨𐑕𐑒
flasks	𐑓𐑤𐑨𐑕𐑒𐑕
flypast	𐑓𐑤𐑲𐑐𐑨𐑕𐑑
flypasts	𐑓𐑤𐑲𐑐𐑨𐑕𐑑𐑕
folk-dance	𐑓𐑴𐑒-𐑛𐑨𐑯𐑕
folk-dances	𐑓𐑴𐑒-𐑛𐑨𐑯𐑕𐑩𐑟
foot-bath	𐑓𐑫𐑑-𐑚𐑨𐑔
foot-baths	𐑓𐑫𐑑-𐑚𐑨𐑞𐑟
footpath	𐑓𐑫𐑑𐑐𐑨𐑔
footpaths	𐑓𐑫𐑑𐑐𐑨𐑞𐑟
for example	𐑓 𐑦𐑜𐑟𐑨𐑥𐑐𐑩𐑤
forecast	𐑓𐑹𐑒𐑨𐑕𐑑
forecasted	𐑓𐑹𐑒𐑨𐑕𐑑𐑩𐑛
forecaster	𐑓𐑹𐑒𐑨𐑕𐑑𐑼
forecasters	𐑓𐑹𐑒𐑨𐑕𐑑𐑼𐑟
forecasting	𐑓𐑹𐑒𐑨𐑕𐑑𐑦𐑙
forecasts	𐑓𐑹𐑒𐑨𐑕𐑑𐑕
foremast	𐑓𐑹𐑥𐑨𐑕𐑑
foremasts	𐑓𐑹𐑥𐑨𐑕𐑑𐑕
fr	𐑓𐑨𐑞𐑼
freelance	𐑓𐑮𐑰𐑤𐑨𐑯𐑕
freelanced	𐑓𐑮𐑰𐑤𐑨𐑯𐑕𐑑
freelances	𐑓𐑮𐑰𐑤𐑨𐑯𐑕𐑩𐑟
freelancing	𐑓𐑮𐑰𐑤𐑨𐑯𐑕𐑦𐑙
gala	𐑜𐑨𐑤𐑩
galas	𐑜𐑨𐑤𐑩𐑟
games-master	𐑜𐑱𐑥𐑟-𐑥𐑨𐑕𐑑𐑼
games-masters	𐑜𐑱𐑥𐑟-𐑥𐑨𐑕𐑑𐑼𐑟
gas-mask	𐑜𐑨𐑕-𐑥𐑨𐑕𐑒
gas-masks	𐑜𐑨𐑕-𐑥𐑨𐑕𐑒𐑕
gasmask	𐑜𐑨𐑕𐑥𐑨𐑕𐑒
gasmasks	𐑜𐑨𐑕𐑥𐑨𐑕𐑒𐑕
gasp	𐑜𐑨𐑕𐑐
gasped	𐑜𐑨𐑕𐑐𐑑
gasping	𐑜𐑨𐑕𐑐𐑦𐑙
gasps	𐑜𐑨𐑕𐑐𐑕
gaza	𐑜𐑨𐑟𐑩
ghanaian	𐑜𐑨𐑯𐑱𐑩𐑯
ghanaians	𐑜𐑨𐑯𐑱𐑩𐑯𐑟
ghani	𐑜𐑨𐑯𐑦
ghastlier	𐑜𐑨𐑕𐑑𐑤𐑦𐑼
ghastliest	𐑜𐑨𐑕𐑑𐑤𐑦𐑩𐑕𐑑
ghastly	𐑜𐑨𐑕𐑑𐑤𐑦
giraffe	𐑡𐑦𐑮𐑨𐑓
giraffes	𐑡𐑦𐑮𐑨𐑓𐑕
glance	𐑜𐑤𐑨𐑯𐑕
glanced	𐑜𐑤𐑨𐑯𐑕𐑑
glances	𐑜𐑤𐑨𐑯𐑕𐑩𐑟
glancing	𐑜𐑤𐑨𐑯𐑕𐑦𐑙
glass	𐑜𐑤𐑨𐑕
glass-blower	𐑜𐑤𐑨𐑕-𐑚𐑤𐑴𐑼
glass-blowers	𐑜𐑤𐑨𐑕-𐑚𐑤𐑴𐑼𐑟
glass-cutter	𐑜𐑤𐑨𐑕-𐑒𐑳𐑑𐑼
glass-cutters	𐑜𐑤𐑨𐑕-𐑒𐑳𐑑𐑼𐑟
glass-wool	𐑜𐑤𐑨𐑕-𐑢𐑫𐑤
glassed	𐑜𐑤𐑨𐑕𐑑
glasses	𐑜𐑤𐑨𐑕𐑩𐑟
glassful	𐑜𐑤𐑨𐑕𐑓𐑫𐑤
glassfuls	𐑜𐑤𐑨𐑕𐑓𐑫𐑤𐑟
glasshouse	𐑜𐑤𐑨𐑕𐑣𐑬𐑕
glasshouses	𐑜𐑤𐑨𐑕𐑣𐑬𐑟𐑩𐑟
glassier	𐑜𐑤𐑨𐑕𐑦𐑼
glassiest	𐑜𐑤𐑨𐑕𐑦𐑩𐑕𐑑
glassily	𐑜𐑤𐑨𐑕𐑦𐑤𐑦
glassing	𐑜𐑤𐑨𐑕𐑦𐑙
glasslands	𐑜𐑤𐑨𐑕𐑤𐑨𐑯𐑛𐑟
glassware	𐑜𐑤𐑨𐑕𐑢𐑺
glassworks	𐑜𐑤𐑨𐑕𐑢𐑻𐑒𐑕
glassy	𐑜𐑤𐑨𐑕𐑦
graft	𐑜𐑮𐑨𐑓𐑑
grafted	𐑜𐑮𐑨𐑓𐑑𐑩𐑛
grafting	𐑜𐑮𐑨𐑓𐑑𐑦𐑙
grafts	𐑜𐑮𐑨𐑓𐑑𐑕
grandaunt	𐑜𐑮𐑨𐑯𐑛𐑨𐑯𐑑
grandaunts	𐑜𐑮𐑨𐑯𐑛𐑨𐑯𐑑𐑕
grant	𐑜𐑮𐑨𐑯𐑑
granted	𐑜𐑮𐑨𐑯𐑑𐑩𐑛
granting	𐑜𐑮𐑨𐑯𐑑𐑦𐑙
grants	𐑜𐑮𐑨𐑯𐑑𐑕
grasp	𐑜𐑮𐑨𐑕𐑐
grasped	𐑜𐑮𐑨𐑕𐑐𐑑
grasping	𐑜𐑮𐑨𐑕𐑐𐑦𐑙
grasps	𐑜𐑮𐑨𐑕𐑐𐑕
grass	𐑜𐑮𐑨𐑕
grassed	𐑜𐑮𐑨𐑕𐑑
grasses	𐑜𐑮𐑨𐑕𐑩𐑟
grasshopper	𐑜𐑮𐑨𐑕𐑣𐑪𐑐𐑼
grasshoppers	𐑜𐑮𐑨𐑕𐑣𐑪𐑐𐑼𐑟
grassier	𐑜𐑮𐑨𐑕𐑦𐑼
grassiest	𐑜𐑮𐑨𐑕𐑦𐑩𐑕𐑑
grassing	𐑜𐑮𐑨𐑕𐑦𐑙
grassland	𐑜𐑮𐑨𐑕𐑤𐑨𐑯𐑛
grasslands	𐑜𐑮𐑨𐑕𐑤𐑨𐑯𐑛𐑟
grassroots	𐑜𐑮𐑨𐑕𐑮𐑵𐑑𐑕
grassy	𐑜𐑮𐑨𐑕𐑦
gratis	𐑜𐑮𐑨𐑑𐑦𐑕
gymkhana	𐑡𐑦𐑥𐑒𐑨𐑯𐑩
gymkhanas	𐑡𐑦𐑥𐑒𐑨𐑯𐑩𐑟
ha	𐑣𐑨
haft	𐑣𐑨𐑓𐑑
hafts	𐑣𐑨𐑓𐑑𐑕
half	𐑣𐑨𐑓
half-baked	𐑣𐑨𐑓-𐑚𐑱𐑒𐑑
half-blood	𐑣𐑨𐑓-𐑚𐑤𐑳𐑛
half-bloods	𐑣𐑨𐑓-𐑚𐑤𐑳𐑛𐑟
half-breed	𐑣𐑨𐑓-𐑚𐑮𐑰𐑛
half-breeds	𐑣𐑨𐑓-𐑚𐑮𐑰𐑛𐑟
half-brother	𐑣𐑨𐑓-𐑚𐑮𐑳𐑞𐑼
half-brothers	𐑣𐑨𐑓-𐑚𐑮𐑳𐑞𐑼𐑟
half-caste	𐑣𐑨𐑓-𐑒𐑨𐑕𐑑
half-castes	𐑣𐑨𐑓-𐑒𐑨𐑕𐑑𐑕
half-crazed	𐑣𐑨𐑓-𐑒𐑮𐑱𐑟𐑛
half-crown	𐑣𐑨𐑓-𐑒𐑮𐑬𐑯
half-crowns	𐑣𐑨𐑓-𐑒𐑮𐑬𐑯𐑟
half-hardy	𐑣𐑨𐑓-𐑣𐑸𐑛𐑦
half-hearted	𐑣𐑨𐑓-𐑣𐑸𐑑𐑩𐑛
half-heartedly	𐑣𐑨𐑓-𐑣𐑸𐑑𐑩𐑛𐑤𐑦
half-holiday	𐑣𐑨𐑓-𐑣𐑪𐑤𐑦𐑛𐑱
half-holidays	𐑣𐑨𐑓-𐑣𐑪𐑤𐑦𐑛𐑱𐑟
half-hour	𐑣𐑨𐑓-𐑬𐑼
half-hourly	𐑣𐑨𐑓-𐑬𐑼𐑤𐑦
half-hours	𐑣𐑨𐑓-𐑬𐑼𐑟
half-length	𐑣𐑨𐑓-𐑤𐑧𐑙𐑔
half-pay	𐑣𐑨𐑓-𐑐𐑱
half-price	𐑣𐑨𐑓-𐑐𐑮𐑲𐑕
half-seas-over	𐑣𐑨𐑓-𐑕𐑰𐑟-𐑴𐑝𐑼
half-sister	𐑣𐑨𐑓-𐑕𐑦𐑕𐑑𐑼
half-sisters	𐑣𐑨𐑓-𐑕𐑦𐑕𐑑𐑼𐑟
half-size	𐑣𐑨𐑓-𐑕𐑲𐑟
half-timbered	𐑣𐑨𐑓-𐑑𐑦𐑥𐑚𐑼𐑛
half-time	𐑣𐑨𐑓-𐑑𐑲𐑥
half-track	𐑣𐑨𐑓-𐑑𐑮𐑨𐑒
half-tracked	𐑣𐑨𐑓-𐑑𐑮𐑨𐑒𐑑
half-tracks	𐑣𐑨𐑓-𐑑𐑮𐑨𐑒𐑕
half-truth	𐑣𐑨𐑓-𐑑𐑮𐑵𐑔
half-truths	𐑣𐑨𐑓-𐑑𐑮𐑵𐑞𐑟
half-volley	𐑣𐑨𐑓-𐑝𐑪𐑤𐑦
half-volleys	𐑣𐑨𐑓-𐑝𐑪𐑤𐑦𐑟
half-yearly	𐑣𐑨𐑓-𐑘𐑽𐑤𐑦
halfback	𐑣𐑨𐑓𐑚𐑨𐑒
halfbacks	𐑣𐑨𐑓𐑚𐑨𐑒𐑕
halftone	𐑣𐑨𐑓𐑑𐑴𐑯
halftones	𐑣𐑨𐑓𐑑𐑴𐑯𐑟
halfway	𐑣𐑨𐑓𐑢𐑱
halfwit	𐑣𐑨𐑓𐑢𐑦𐑑
halfwits	𐑣𐑨𐑓𐑢𐑦𐑑𐑕
halfwitted	𐑣𐑨𐑓𐑢𐑦𐑑𐑩𐑛
halve	𐑣𐑨𐑝
halved	𐑣𐑨𐑝𐑛
halves	𐑣𐑨𐑝𐑟
halving	𐑣𐑨𐑝𐑦𐑙
handicraft	𐑣𐑨𐑯𐑛𐑦𐑒𐑮𐑨𐑓𐑑
handicrafts	𐑣𐑨𐑯𐑛𐑦𐑒𐑮𐑨𐑓𐑑𐑕
hasp	𐑣𐑨𐑕𐑐
hasps	𐑣𐑨𐑕𐑐𐑕
headmaster	𐑣𐑧𐑛𐑥𐑨𐑕𐑑𐑼
headmasters	𐑣𐑧𐑛𐑥𐑨𐑕𐑑𐑼𐑟
hereafter	𐑣𐑽𐑨𐑓𐑑𐑼
hereinafter	𐑣𐑽𐑦𐑯𐑨𐑓𐑑𐑼
high-class	𐑣𐑲-𐑒𐑤𐑨𐑕
hindustani	𐑣𐑦𐑯𐑛𐑫𐑕𐑑𐑨𐑯𐑦
hindustanis	𐑣𐑦𐑯𐑛𐑫𐑕𐑑𐑨𐑯𐑦𐑟
hip-bath	𐑣𐑦𐑐-𐑚𐑨𐑔
hip-baths	𐑣𐑦𐑐-𐑚𐑨𐑞𐑟
hip-flask	𐑣𐑦𐑐-𐑓𐑤𐑨𐑕𐑒
hip-flasks	𐑣𐑦𐑐-𐑓𐑤𐑨𐑕𐑒𐑕
horse-laugh	𐑣𐑹𐑕-𐑤𐑨𐑓
horse-laughs	𐑣𐑹𐑕-𐑤𐑨𐑓𐑕
hourglass	𐑬𐑼𐑜𐑤𐑨𐑕
hourglasses	𐑬𐑼𐑜𐑤𐑨𐑕𐑩𐑟
housecraft	𐑣𐑬𐑕𐑒𐑮𐑨𐑓𐑑
housemaster	𐑣𐑬𐑕𐑥𐑨𐑕𐑑𐑼
housemasters	𐑣𐑬𐑕𐑥𐑨𐑕𐑑𐑼𐑟
hovercraft	𐑣𐑪𐑝𐑼𐑒𐑮𐑨𐑓𐑑
imam	𐑦𐑥𐑨𐑥
imams	𐑦𐑥𐑨𐑥𐑟
impassable	𐑦𐑥𐑐𐑨𐑕𐑩𐑚𐑩𐑤
implant	𐑦𐑥𐑐𐑤𐑨𐑯𐑑
implantation	𐑦𐑥𐑐𐑤𐑨𐑯𐑑𐑱𐑖𐑩𐑯
implanted	𐑦𐑥𐑐𐑤𐑨𐑯𐑑𐑩𐑛
implanting	𐑦𐑥𐑐𐑤𐑨𐑯𐑑𐑦𐑙
implants	𐑦𐑥𐑐𐑤𐑨𐑯𐑑𐑕
ingraft	𐑦𐑯𐑜𐑮𐑨𐑓𐑑
ingrafted	𐑦𐑯𐑜𐑮𐑨𐑓𐑑𐑩𐑛
ingrafting	𐑦𐑯𐑜𐑮𐑨𐑓𐑑𐑦𐑙
ingrafts	𐑦𐑯𐑜𐑮𐑨𐑓𐑑𐑕
isinglass	𐑲𐑟𐑦𐑙𐑜𐑤𐑨𐑕
islam	𐑦𐑟𐑤𐑨𐑥
islamic	𐑦𐑟𐑤𐑨𐑥𐑦𐑒
jury-mast	𐑡𐑫𐑼𐑦-𐑥𐑨𐑕𐑑
jury-masts	𐑡𐑫𐑼𐑦-𐑥𐑨𐑕𐑑𐑕
kazakhstan	𐑒𐑨𐑟𐑨𐑒𐑕𐑑𐑨𐑯
keep-off-the-grass	𐑒𐑰𐑐-𐑪𐑓-𐑞-𐑜𐑮𐑨𐑕
khaki	𐑒𐑨𐑒𐑦
kohlrabi	𐑒𐑴𐑤𐑮𐑨𐑚𐑦
kohlrabis	𐑒𐑴𐑤𐑮𐑨𐑚𐑦𐑟
koran	𐑒𐑼𐑨𐑯
korans	𐑒𐑼𐑨𐑯𐑟
lakh	𐑤𐑨𐑒
lakhs	𐑤𐑨𐑒𐑕
lance	𐑤𐑨𐑯𐑕
lance-corporal	𐑤𐑨𐑯𐑕-𐑒𐑹𐑐𐑼𐑩𐑤
lance-corporals	𐑤𐑨𐑯𐑕-𐑒𐑹𐑐𐑼𐑩𐑤𐑟
lanced	𐑤𐑨𐑯𐑕𐑑
lancer	𐑤𐑨𐑯𐑕𐑼
lancers	𐑤𐑨𐑯𐑕𐑼𐑟
lances	𐑤𐑨𐑯𐑕𐑩𐑟
lancet	𐑤𐑨𐑯𐑕𐑩𐑑
lancets	𐑤𐑨𐑯𐑕𐑩𐑑𐑕
lancing	𐑤𐑨𐑯𐑕𐑦𐑙
landing-craft	𐑤𐑨𐑯𐑛𐑦𐑙-𐑒𐑮𐑨𐑓𐑑
last	𐑤𐑨𐑕𐑑
lasted	𐑤𐑨𐑕𐑑𐑩𐑛
lasting	𐑤𐑨𐑕𐑑𐑦𐑙
lastly	𐑤𐑨𐑕𐑑𐑤𐑦
lasts	𐑤𐑨𐑕𐑑𐑕
lath	𐑤𐑨𐑔
lather	𐑤𐑨𐑞𐑼
lathered	𐑤𐑨𐑞𐑼𐑛
lathering	𐑤𐑨𐑞𐑼𐑦𐑙
lathers	𐑤𐑨𐑞𐑼𐑟
lathi	𐑤𐑨𐑑𐑦
laths	𐑤𐑨𐑞𐑟
laugh	𐑤𐑨𐑓
laughable	𐑤𐑨𐑓𐑩𐑚𐑩𐑤
laughably	𐑤𐑨𐑓𐑩𐑚𐑤𐑦
laughed	𐑤𐑨𐑓𐑑
laughing	𐑤𐑨𐑓𐑦𐑙
laughing-gas	𐑤𐑨𐑓𐑦𐑙-𐑜𐑨𐑕
laughing-stock	𐑤𐑨𐑓𐑦𐑙-𐑕𐑑𐑪𐑒
laughing-stocks	𐑤𐑨𐑓𐑦𐑙-𐑕𐑑𐑪𐑒𐑕
laughingly	𐑤𐑨𐑓𐑦𐑙𐑤𐑦
laughs	𐑤𐑨𐑓𐑕
laughter	𐑤𐑨𐑓𐑑𐑼
lava	𐑤𐑨𐑝𐑩
liana	𐑤𐑦𐑨𐑯𐑩
lianas	𐑤𐑦𐑨𐑯𐑩𐑟
life-raft	𐑤𐑲𐑓-𐑮𐑨𐑓𐑑
life-rafts	𐑤𐑲𐑓-𐑮𐑨𐑓𐑑𐑕
litter-basket	𐑤𐑦𐑑𐑼-𐑚𐑨𐑕𐑒𐑩𐑑
litter-baskets	𐑤𐑦𐑑𐑼-𐑚𐑨𐑕𐑒𐑩𐑑𐑕
locale	𐑤𐑴𐑒𐑨𐑤
locales	𐑤𐑴𐑒𐑨𐑤𐑟
looking-glass	𐑤𐑫𐑒𐑦𐑙-𐑜𐑤𐑨𐑕
looking-glasses	𐑤𐑫𐑒𐑦𐑙-𐑜𐑤𐑨𐑕𐑩𐑟
macaque	𐑥𐑩𐑒𐑨𐑒
madame	𐑥𐑩𐑛𐑨𐑥
madames	𐑥𐑩𐑛𐑨𐑥𐑟
mafia	𐑥𐑨𐑓𐑾
mafias	𐑥𐑨𐑓𐑾𐑟
mahatma	𐑥𐑩𐑣𐑨𐑑𐑥𐑩
mahatmas	𐑥𐑩𐑣𐑨𐑑𐑥𐑩𐑟
mainmast	𐑥𐑱𐑯𐑥𐑨𐑕𐑑
mainmasts	𐑥𐑱𐑯𐑥𐑨𐑕𐑑𐑕
malawian	𐑥𐑩𐑤𐑨𐑢𐑾𐑯
malawians	𐑥𐑩𐑤𐑨𐑢𐑾𐑯𐑟
mask	𐑥𐑨𐑕𐑒
masked	𐑥𐑨𐑕𐑒𐑑
masking	𐑥𐑨𐑕𐑒𐑦𐑙
masks	𐑥𐑨𐑕𐑒𐑕
masque	𐑥𐑨𐑕𐑒
masquerade	𐑥𐑨𐑕𐑒𐑼𐑱𐑛
masqueraded	𐑥𐑨𐑕𐑒𐑼𐑱𐑛𐑩𐑛
masquerades	𐑥𐑨𐑕𐑒𐑼𐑱𐑛𐑟
masquerading	𐑥𐑨𐑕𐑒𐑼𐑱𐑛𐑦𐑙
masques	𐑥𐑨𐑕𐑒𐑕
mast	𐑥𐑨𐑕𐑑
master	𐑥𐑨𐑕𐑑𐑼
master-at-arms	𐑥𐑨𐑕𐑑𐑼-𐑨𐑑-𐑸𐑥𐑟
master-key	𐑥𐑨𐑕𐑑𐑼-𐑒𐑰
master-keys	𐑥𐑨𐑕𐑑𐑼-𐑒𐑰𐑟
mastered	𐑥𐑨𐑕𐑑𐑼𐑛
masterful	𐑥𐑨𐑕𐑑𐑼𐑓𐑩𐑤
masterfully	𐑥𐑨𐑕𐑑𐑼𐑓𐑩𐑤𐑦
mastering	𐑥𐑨𐑕𐑑𐑼𐑦𐑙
masterless	𐑥𐑨𐑕𐑑𐑼𐑤𐑩𐑕
masterly	𐑥𐑨𐑕𐑑𐑼𐑤𐑦
mastermind	𐑥𐑨𐑕𐑑𐑼𐑥𐑲𐑯𐑛
masterminded	𐑥𐑨𐑕𐑑𐑼𐑥𐑲𐑯𐑛𐑩𐑛
masterminding	𐑥𐑨𐑕𐑑𐑼𐑥𐑲𐑯𐑛𐑦𐑙
masterminds	𐑥𐑨𐑕𐑑𐑼𐑥𐑲𐑯𐑛𐑟
masterpiece	𐑥𐑨𐑕𐑑𐑼𐑐𐑰𐑕
masterpieces	𐑥𐑨𐑕𐑑𐑼𐑐𐑰𐑕𐑩𐑟
masters	𐑥𐑨𐑕𐑑𐑼𐑟
masters-at-arms	𐑥𐑨𐑕𐑑𐑼𐑟-𐑨𐑑-𐑸𐑥𐑟
mastership	𐑥𐑨𐑕𐑑𐑼𐑖𐑦𐑐
masterships	𐑥𐑨𐑕𐑑𐑼𐑖𐑦𐑐𐑕
masterstroke	𐑥𐑨𐑕𐑑𐑼𐑕𐑑𐑮𐑴𐑒
masterstrokes	𐑥𐑨𐑕𐑑𐑼𐑕𐑑𐑮𐑴𐑒𐑕
mastery	𐑥𐑨𐑕𐑑𐑼𐑦
masthead	𐑥𐑨𐑕𐑑𐑣𐑧𐑛
mastheads	𐑥𐑨𐑕𐑑𐑣𐑧𐑛𐑟
masts	𐑥𐑨𐑕𐑑𐑕
melodrama	𐑥𐑧𐑤𐑩𐑛𐑮𐑨𐑥𐑩
melodramas	𐑥𐑧𐑤𐑩𐑛𐑮𐑨𐑥𐑩𐑟
mesdames	𐑥𐑱𐑛𐑨𐑥
mezzo-soprano	𐑥𐑧𐑑𐑕𐑴-𐑕𐑩𐑐𐑮𐑨𐑯𐑴
mezzo-sopranos	𐑥𐑧𐑑𐑕𐑴-𐑕𐑩𐑐𐑮𐑨𐑯𐑴𐑟
middle-class	𐑥𐑦𐑛𐑩𐑤-𐑒𐑤𐑨𐑕
miscast	𐑥𐑦𐑕𐑒𐑨𐑕𐑑
miscasting	𐑥𐑦𐑕𐑒𐑨𐑕𐑑𐑦𐑙
miscasts	𐑥𐑦𐑕𐑒𐑨𐑕𐑑𐑕
mischance	𐑥𐑦𐑕𐑗𐑨𐑯𐑕
mischances	𐑥𐑦𐑕𐑗𐑨𐑯𐑕𐑩𐑟
mizzen-mast	𐑥𐑦𐑟𐑩𐑯-𐑥𐑨𐑕𐑑
mizzen-masts	𐑥𐑦𐑟𐑩𐑯-𐑥𐑨𐑕𐑑𐑕
mooring-mast	𐑥𐑫𐑼𐑦𐑙-𐑥𐑨𐑕𐑑
mooring-masts	𐑥𐑫𐑼𐑦𐑙-𐑥𐑨𐑕𐑑𐑕
morale	𐑥𐑼𐑨𐑤
morris dance	𐑥𐑪𐑮𐑦𐑕 𐑛𐑨𐑯𐑕
morris dances	𐑥𐑪𐑮𐑦𐑕 𐑛𐑨𐑯𐑕𐑩𐑟
mosquito-craft	𐑥𐑩𐑕𐑒𐑰𐑑𐑴-𐑒𐑮𐑨𐑓𐑑
moustache	𐑥𐑩𐑕𐑑𐑨𐑖
moustaches	𐑥𐑩𐑕𐑑𐑨𐑖𐑩𐑟
mud-bath	𐑥𐑳𐑛-𐑚𐑨𐑔
mud-baths	𐑥𐑳𐑛-𐑚𐑨𐑞𐑟
mustachio	𐑥𐑩𐑕𐑑𐑨𐑖𐑦𐑴
mustachios	𐑥𐑩𐑕𐑑𐑨𐑖𐑦𐑴𐑟
nastier	𐑯𐑨𐑕𐑑𐑦𐑼
nastiest	𐑯𐑨𐑕𐑑𐑦𐑩𐑕𐑑
nastily	𐑯𐑨𐑕𐑑𐑦𐑤𐑦
nastiness	𐑯𐑨𐑕𐑑𐑦𐑯𐑩𐑕
nasty	𐑯𐑨𐑕𐑑𐑦
nasty-looking	𐑯𐑨𐑕𐑑𐑦-𐑤𐑫𐑒𐑦𐑙
nazi	𐑯𐑨𐑑𐑕𐑦
nazis	𐑯𐑨𐑑𐑕𐑦𐑟
nazism	𐑯𐑨𐑑𐑕𐑦𐑟𐑩𐑥
needlecraft	𐑯𐑰𐑛𐑩𐑤𐑒𐑮𐑨𐑓𐑑
newscast	𐑯𐑿𐑟𐑒𐑨𐑕𐑑
newscaster	𐑯𐑿𐑟𐑒𐑨𐑕𐑑𐑼
newscasters	𐑯𐑿𐑟𐑒𐑨𐑕𐑑𐑼𐑟
newscasts	𐑯𐑿𐑟𐑒𐑨𐑕𐑑𐑕
omani	𐑴𐑥𐑨𐑯𐑦
omanis	𐑴𐑥𐑨𐑯𐑦𐑟
on-demand	𐑪𐑯-𐑛𐑦𐑥𐑨𐑯𐑛
opencast	𐑴𐑐𐑩𐑯𐑒𐑨𐑕𐑑
opera-glasses	𐑪𐑐𐑼𐑩-𐑜𐑤𐑨𐑕𐑩𐑟
outcast	𐑬𐑑𐑒𐑨𐑕𐑑
outcaste	𐑬𐑑𐑒𐑨𐑕𐑑
outcastes	𐑬𐑑𐑒𐑨𐑕𐑑𐑕
outcasts	𐑬𐑑𐑒𐑨𐑕𐑑𐑕
outclass	𐑬𐑑𐑒𐑤𐑨𐑕
outclassed	𐑬𐑑𐑒𐑤𐑨𐑕𐑑
outclasses	𐑬𐑑𐑒𐑤𐑨𐑕𐑩𐑟
outclassing	𐑬𐑑𐑒𐑤𐑨𐑕𐑦𐑙
outlast	𐑬𐑑𐑤𐑨𐑕𐑑
outlasted	𐑬𐑑𐑤𐑨𐑕𐑑𐑩𐑛
outlasting	𐑬𐑑𐑤𐑨𐑕𐑑𐑦𐑙
outlasts	𐑬𐑑𐑤𐑨𐑕𐑑𐑕
overcast	𐑴𐑝𐑼𐑒𐑨𐑕𐑑
overdraft	𐑴𐑝𐑼𐑛𐑮𐑨𐑓𐑑
overdrafts	𐑴𐑝𐑼𐑛𐑮𐑨𐑓𐑑𐑕
overmaster	𐑴𐑝𐑼𐑥𐑨𐑕𐑑𐑼
overmastered	𐑴𐑝𐑼𐑥𐑨𐑕𐑑𐑼𐑛
overmastering	𐑴𐑝𐑼𐑥𐑨𐑕𐑑𐑼𐑦𐑙
overmasters	𐑴𐑝𐑼𐑥𐑨𐑕𐑑𐑼𐑟
overpass	𐑴𐑝𐑼𐑐𐑨𐑕
overpasses	𐑴𐑝𐑼𐑐𐑨𐑕𐑩𐑟
pajamas	𐑐𐑩𐑡𐑨𐑥𐑩𐑟
pakistani	𐑐𐑨𐑒𐑦𐑕𐑑𐑨𐑯𐑦
pakistanis	𐑐𐑨𐑒𐑦𐑕𐑑𐑨𐑯𐑦𐑟
palaver	𐑐𐑩𐑤𐑨𐑝𐑼
palavered	𐑐𐑩𐑤𐑨𐑝𐑼𐑛
palavering	𐑐𐑩𐑤𐑨𐑝𐑼𐑦𐑙
palavers	𐑐𐑩𐑤𐑨𐑝𐑼𐑟
pampas-grass	𐑐𐑨𐑥𐑐𐑩𐑕-𐑜𐑮𐑨𐑕
panorama	𐑐𐑨𐑯𐑼𐑨𐑥𐑩
panoramas	𐑐𐑨𐑯𐑼𐑨𐑥𐑩𐑟
pasha	𐑐𐑨𐑖𐑩
pashas	𐑐𐑨𐑖𐑩𐑟
pass	𐑐𐑨𐑕
passable	𐑐𐑨𐑕𐑩𐑚𐑩𐑤
passably	𐑐𐑨𐑕𐑩𐑚𐑤𐑦
passbook	𐑐𐑨𐑕𐑚𐑫𐑒
passbooks	𐑐𐑨𐑕𐑚𐑫𐑒𐑕
passcode	𐑐𐑨𐑕𐑒𐑴𐑛
passed	𐑐𐑨𐑕𐑑
passer-by	𐑐𐑨𐑕𐑼-𐑚𐑲
passers-by	𐑐𐑨𐑕𐑼𐑟-𐑚𐑲
passes	𐑐𐑨𐑕𐑩𐑟
passing	𐑐𐑨𐑕𐑦𐑙
passing-out	𐑐𐑨𐑕𐑦𐑙-𐑬𐑑
passkey	𐑐𐑨𐑕𐑒𐑰
passkeys	𐑐𐑨𐑕𐑒𐑰𐑟
passover	𐑐𐑨𐑕𐑴𐑝𐑼
passovers	𐑐𐑨𐑕𐑴𐑝𐑼𐑟
passport	𐑐𐑨𐑕𐑐𐑹𐑑
passports	𐑐𐑨𐑕𐑐𐑹𐑑𐑕
password	𐑐𐑨𐑕𐑢𐑻𐑛
passwords	𐑐𐑨𐑕𐑢𐑻𐑛𐑟
past	𐑐𐑨𐑕𐑑
pasta	𐑐𐑨𐑕𐑑𐑩
pasteurisation	𐑐𐑨𐑕𐑗𐑼𐑲𐑟𐑱𐑖𐑩𐑯
pasteurise	𐑐𐑨𐑕𐑗𐑼𐑲𐑟
pasteurised	𐑐𐑨𐑕𐑗𐑼𐑲𐑟𐑛
pasteurises	𐑐𐑨𐑕𐑗𐑼𐑲𐑟𐑩𐑟
pasteurising	𐑐𐑨𐑕𐑗𐑼𐑲𐑟𐑦𐑙
pasteurization	𐑐𐑨𐑕𐑗𐑼𐑲𐑟𐑱𐑖𐑩𐑯
pasteurize	𐑐𐑨𐑕𐑗𐑼𐑲𐑟
pasteurized	𐑐𐑨𐑕𐑗𐑼𐑲𐑟𐑛
pasteurizes	𐑐𐑨𐑕𐑗𐑼𐑲𐑟𐑩𐑟
pasteurizing	𐑐𐑨𐑕𐑗𐑼𐑲𐑟𐑦𐑙
pastime	𐑐𐑨𐑕𐑑𐑲𐑥
pastimes	𐑐𐑨𐑕𐑑𐑲𐑥𐑟
pastor	𐑐𐑨𐑕𐑑𐑼
pastoral	𐑐𐑨𐑕𐑑𐑼𐑩𐑤
pastorals	𐑐𐑨𐑕𐑑𐑼𐑩𐑤𐑟
pastorate	𐑐𐑨𐑕𐑑𐑼𐑩𐑑
pastorates	𐑐𐑨𐑕𐑑𐑼𐑩𐑑𐑕
pastors	𐑐𐑨𐑕𐑑𐑼𐑟
pasts	𐑐𐑨𐑕𐑑𐑕
pasturage	𐑐𐑨𐑕𐑗𐑼𐑦𐑡
pasture	𐑐𐑨𐑕𐑗𐑼
pastured	𐑐𐑨𐑕𐑗𐑼𐑛
pastures	𐑐𐑨𐑕𐑗𐑼𐑟
pasturing	𐑐𐑨𐑕𐑗𐑼𐑦𐑙
path	𐑐𐑨𐑔
path-finder	𐑐𐑨𐑔-𐑓𐑲𐑯𐑛𐑼
path-finders	𐑐𐑨𐑔-𐑓𐑲𐑯𐑛𐑼𐑟
pathless	𐑐𐑨𐑔𐑤𐑩𐑕
paths	𐑐𐑨𐑞𐑟
pathway	𐑐𐑨𐑔𐑢𐑱
pathways	𐑐𐑨𐑔𐑢𐑱𐑟
paymaster	𐑐𐑱𐑥𐑨𐑕𐑑𐑼
paymasters	𐑐𐑱𐑥𐑨𐑕𐑑𐑼𐑟
perchance	𐑐𐑼𐑗𐑨𐑯𐑕
persona grata	𐑐𐑼𐑕𐑴𐑯𐑩 𐑜𐑮𐑨𐑑𐑩
persona non grata	𐑐𐑼𐑕𐑴𐑯𐑩 𐑯𐑪𐑯 𐑜𐑮𐑨𐑑𐑩
piano	𐑐𐑘𐑨𐑯𐑴
pier-glass	𐑐𐑽-𐑜𐑤𐑨𐑕
pier-glasses	𐑐𐑽-𐑜𐑤𐑨𐑕𐑩𐑟
pikestaff	𐑐𐑲𐑒𐑕𐑑𐑨𐑓
pikestaffs	𐑐𐑲𐑒𐑕𐑑𐑨𐑓𐑕
piranha	𐑐𐑦𐑮𐑨𐑯𐑘𐑩
piranhas	𐑐𐑦𐑮𐑨𐑯𐑘𐑩𐑟
planchette	𐑐𐑤𐑨𐑯𐑖𐑧𐑑
planchettes	𐑐𐑤𐑨𐑯𐑖𐑧𐑑𐑕
plant	𐑐𐑤𐑨𐑯𐑑
plant-lice	𐑐𐑤𐑨𐑯𐑑-𐑤𐑲𐑕
plant-louse	𐑐𐑤𐑨𐑯𐑑-𐑤𐑬𐑕
planted	𐑐𐑤𐑨𐑯𐑑𐑩𐑛
planter	𐑐𐑤𐑨𐑯𐑑𐑼
planters	𐑐𐑤𐑨𐑯𐑑𐑼𐑟
planting	𐑐𐑤𐑨𐑯𐑑𐑦𐑙
plants	𐑐𐑤𐑨𐑯𐑑𐑕
plaque	𐑐𐑤𐑨𐑒
plaques	𐑐𐑤𐑨𐑒𐑕
plaster	𐑐𐑤𐑨𐑕𐑑𐑼
plasterboard	𐑐𐑤𐑨𐑕𐑑𐑼𐑚𐑹𐑛
plastered	𐑐𐑤𐑨𐑕𐑑𐑼𐑛
plasterer	𐑐𐑤𐑨𐑕𐑑𐑼𐑼
plasterers	𐑐𐑤𐑨𐑕𐑑𐑼𐑼𐑟
plastering	𐑐𐑤𐑨𐑕𐑑𐑼𐑦𐑙
plasters	𐑐𐑤𐑨𐑕𐑑𐑼𐑟
plate-glass	𐑐𐑤𐑱𐑑-𐑜𐑤𐑨𐑕
plaza	𐑐𐑤𐑨𐑟𐑩
plazas	𐑐𐑤𐑨𐑟𐑩𐑟
pleasure-craft	𐑐𐑤𐑧𐑠𐑼-𐑒𐑮𐑨𐑓𐑑
pleasure-crafts	𐑐𐑤𐑧𐑠𐑼-𐑒𐑮𐑨𐑓𐑑𐑕
postmaster	𐑐𐑴𐑕𐑑𐑥𐑨𐑕𐑑𐑼
postmasters	𐑐𐑴𐑕𐑑𐑥𐑨𐑕𐑑𐑼𐑟
powder-flask	𐑐𐑬𐑛𐑼-𐑓𐑤𐑨𐑕𐑒
powder-flasks	𐑐𐑬𐑛𐑼-𐑓𐑤𐑨𐑕𐑒𐑕
prance	𐑐𐑮𐑨𐑯𐑕
pranced	𐑐𐑮𐑨𐑯𐑕𐑑
prances	𐑐𐑮𐑨𐑯𐑕𐑩𐑟
prancing	𐑐𐑮𐑨𐑯𐑕𐑦𐑙
precast	𐑐𐑮𐑰𐑒𐑨𐑕𐑑
priestcraft	𐑐𐑮𐑰𐑕𐑑𐑒𐑮𐑨𐑓𐑑
property-master	𐑐𐑮𐑪𐑐𐑼𐑑𐑦-𐑥𐑨𐑕𐑑𐑼
property-masters	𐑐𐑮𐑪𐑐𐑼𐑑𐑦-𐑥𐑨𐑕𐑑𐑼𐑟
pyjama	𐑐𐑩𐑡𐑨𐑥𐑩
pyjamas	𐑐𐑩𐑡𐑨𐑥𐑩𐑟
quartermaster	𐑒𐑢𐑹𐑑𐑼𐑥𐑨𐑕𐑑𐑼
quartermaster-general	𐑒𐑢𐑹𐑑𐑼𐑥𐑨𐑕𐑑𐑼-𐑡𐑧𐑯𐑼𐑩𐑤
quartermaster-generals	𐑒𐑢𐑹𐑑𐑼𐑥𐑨𐑕𐑑𐑼-𐑡𐑧𐑯𐑼𐑩𐑤𐑟
quartermasters	𐑒𐑢𐑹𐑑𐑼𐑥𐑨𐑕𐑑𐑼𐑟
quarterstaff	𐑒𐑢𐑹𐑑𐑼𐑕𐑑𐑨𐑓
quarterstaffs	𐑒𐑢𐑹𐑑𐑼𐑕𐑑𐑨𐑓𐑕
question-master	𐑒𐑢𐑧𐑕𐑗𐑩𐑯-𐑥𐑨𐑕𐑑𐑼
question-masters	𐑒𐑢𐑧𐑕𐑗𐑩𐑯-𐑥𐑨𐑕𐑑𐑼𐑟
quizmaster	𐑒𐑢𐑦𐑟𐑥𐑨𐑕𐑑𐑼
quizmasters	𐑒𐑢𐑦𐑟𐑥𐑨𐑕𐑑𐑼𐑟
raft	𐑮𐑨𐑓𐑑
rafted	𐑮𐑨𐑓𐑑𐑩𐑛
rafter	𐑮𐑨𐑓𐑑𐑼
raftered	𐑮𐑨𐑓𐑑𐑼𐑛
rafters	𐑮𐑨𐑓𐑑𐑼𐑟
rafting	𐑮𐑨𐑓𐑑𐑦𐑙
rafts	𐑮𐑨𐑓𐑑𐑕
raftsman	𐑮𐑨𐑓𐑑𐑕𐑥𐑩𐑯
raftsmen	𐑮𐑨𐑓𐑑𐑕𐑥𐑧𐑯
rascal	𐑮𐑨𐑕𐑒𐑩𐑤
rascally	𐑮𐑨𐑕𐑒𐑩𐑤𐑦
rascals	𐑮𐑨𐑕𐑒𐑩𐑤𐑟
rasp	𐑮𐑨𐑕𐑐
raspberries	𐑮𐑨𐑟𐑚𐑼𐑦𐑟
raspberry	𐑮𐑨𐑟𐑚𐑼𐑦
rasped	𐑮𐑨𐑕𐑐𐑑
rasping	𐑮𐑨𐑕𐑐𐑦𐑙
raspingly	𐑮𐑨𐑕𐑐𐑦𐑙𐑤𐑦
rasps	𐑮𐑨𐑕𐑐𐑕
rather	𐑮𐑨𐑞𐑼
rationale	𐑮𐑨𐑖𐑩𐑯𐑨𐑤
rationales	𐑮𐑨𐑖𐑩𐑯𐑨𐑤𐑟
reading-glasses	𐑮𐑰𐑛𐑦𐑙-𐑜𐑤𐑨𐑕𐑩𐑟
recast	𐑮𐑰𐑒𐑨𐑕𐑑
recasting	𐑮𐑰𐑒𐑨𐑕𐑑𐑦𐑙
recasts	𐑮𐑰𐑒𐑨𐑕𐑑𐑕
remand	𐑮𐑦𐑥𐑨𐑯𐑛
remanded	𐑮𐑦𐑥𐑨𐑯𐑛𐑩𐑛
remanding	𐑮𐑦𐑥𐑨𐑯𐑛𐑦𐑙
remands	𐑮𐑦𐑥𐑨𐑯𐑛𐑟
repast	𐑮𐑦𐑐𐑨𐑕𐑑
repasts	𐑮𐑦𐑐𐑨𐑕𐑑𐑕
replant	𐑮𐑰𐑐𐑤𐑨𐑯𐑑
replanted	𐑮𐑰𐑐𐑤𐑨𐑯𐑑𐑩𐑛
replanting	𐑮𐑰𐑐𐑤𐑨𐑯𐑑𐑦𐑙
replants	𐑮𐑰𐑐𐑤𐑨𐑯𐑑𐑕
reprimand	𐑮𐑧𐑐𐑮𐑦𐑥𐑨𐑯𐑛
reprimanded	𐑮𐑧𐑐𐑮𐑦𐑥𐑨𐑯𐑛𐑩𐑛
reprimanding	𐑮𐑧𐑐𐑮𐑦𐑥𐑨𐑯𐑛𐑦𐑙
reprimands	𐑮𐑧𐑐𐑮𐑦𐑥𐑨𐑯𐑛𐑟
riding-master	𐑮𐑲𐑛𐑦𐑙-𐑥𐑨𐑕𐑑𐑼
riding-masters	𐑮𐑲𐑛𐑦𐑙-𐑥𐑨𐑕𐑑𐑼𐑟
ringmaster	𐑮𐑦𐑙𐑥𐑨𐑕𐑑𐑼
ringmasters	𐑮𐑦𐑙𐑥𐑨𐑕𐑑𐑼𐑟
rock-plant	𐑮𐑪𐑒-𐑐𐑤𐑨𐑯𐑑
rock-plants	𐑮𐑪𐑒-𐑐𐑤𐑨𐑯𐑑𐑕
rope-dancer	𐑮𐑴𐑐-𐑛𐑨𐑯𐑕𐑼
rope-dancers	𐑮𐑴𐑐-𐑛𐑨𐑯𐑕𐑼𐑟
roughcast	𐑮𐑳𐑓𐑒𐑨𐑕𐑑
roughcasting	𐑮𐑳𐑓𐑒𐑨𐑕𐑑𐑦𐑙
roughcasts	𐑮𐑳𐑓𐑒𐑨𐑕𐑑𐑕
saga	𐑕𐑨𐑜𐑩
sagas	𐑕𐑨𐑜𐑩𐑟
sailing-master	𐑕𐑱𐑤𐑦𐑙-𐑥𐑨𐑕𐑑𐑼
sailing-masters	𐑕𐑱𐑤𐑦𐑙-𐑥𐑨𐑕𐑑𐑼𐑟
sample	𐑕𐑨𐑥𐑐𐑩𐑤
sampled	𐑕𐑨𐑥𐑐𐑩𐑤𐑛
sampler	𐑕𐑨𐑥𐑐𐑤𐑼
samplers	𐑕𐑨𐑥𐑐𐑤𐑼𐑟
samples	𐑕𐑨𐑥𐑐𐑩𐑤𐑟
sampling	𐑕𐑨𐑥𐑐𐑤𐑦𐑙
sandblast	𐑕𐑨𐑯𐑛𐑚𐑤𐑨𐑕𐑑
sandblasted	𐑕𐑨𐑯𐑛𐑚𐑤𐑨𐑕𐑑𐑩𐑛
sandblasting	𐑕𐑨𐑯𐑛𐑚𐑤𐑨𐑕𐑑𐑦𐑙
sandblasts	𐑕𐑨𐑯𐑛𐑚𐑤𐑨𐑕𐑑𐑕
sandglass	𐑕𐑨𐑯𐑛𐑜𐑤𐑨𐑕
sandglasses	𐑕𐑨𐑯𐑛𐑜𐑤𐑨𐑕𐑩𐑟
schoolmaster	𐑕𐑒𐑵𐑤𐑥𐑨𐑕𐑑𐑼
schoolmasters	𐑕𐑒𐑵𐑤𐑥𐑨𐑕𐑑𐑼𐑟
scoutmaster	𐑕𐑒𐑬𐑑𐑥𐑨𐑕𐑑𐑼
scoutmasters	𐑕𐑒𐑬𐑑𐑥𐑨𐑕𐑑𐑼𐑟
second-class	𐑕𐑧𐑒𐑩𐑯𐑛-𐑒𐑤𐑨𐑕
self-command	𐑕𐑧𐑤𐑓-𐑒𐑩𐑥𐑨𐑯𐑛
shaft	𐑖𐑨𐑓𐑑
shafts	𐑖𐑨𐑓𐑑𐑕
shan't	𐑖𐑨𐑯𐑑
ship's-chandler	𐑖𐑰𐑐𐑕-𐑗𐑨𐑯𐑛𐑤𐑼
ship's-chandlers	𐑖𐑰𐑐𐑕-𐑗𐑨𐑯𐑛𐑤𐑼𐑟
shower-bath	𐑖𐑬𐑼-𐑚𐑨𐑔
shower-baths	𐑖𐑬𐑼-𐑚𐑨𐑞𐑟
side-glance	𐑕𐑲𐑛-𐑜𐑤𐑨𐑯𐑕
side-glances	𐑕𐑲𐑛-𐑜𐑤𐑨𐑯𐑕𐑩𐑟
skin-graft	𐑕𐑒𐑦𐑯-𐑜𐑮𐑨𐑓𐑑
skin-grafts	𐑕𐑒𐑦𐑯-𐑜𐑮𐑨𐑓𐑑𐑕
slander	𐑕𐑤𐑨𐑯𐑛𐑼
slandered	𐑕𐑤𐑨𐑯𐑛𐑼𐑛
slanderer	𐑕𐑤𐑨𐑯𐑛𐑼𐑼
slanderers	𐑕𐑤𐑨𐑯𐑛𐑼𐑼𐑟
slandering	𐑕𐑤𐑨𐑯𐑛𐑼𐑦𐑙
slanderous	𐑕𐑤𐑨𐑯𐑛𐑼𐑩𐑕
slanders	𐑕𐑤𐑨𐑯𐑛𐑼𐑟
slant	𐑕𐑤𐑨𐑯𐑑
slanted	𐑕𐑤𐑨𐑯𐑑𐑩𐑛
slanting	𐑕𐑤𐑨𐑯𐑑𐑦𐑙
slantingly	𐑕𐑤𐑨𐑯𐑑𐑦𐑙𐑤𐑦
slants	𐑕𐑤𐑨𐑯𐑑𐑕
slantwise	𐑕𐑤𐑨𐑯𐑑𐑢𐑲𐑟
slav	𐑕𐑤𐑨𐑝
slavs	𐑕𐑤𐑨𐑝𐑟
sleeping-draught	𐑕𐑤𐑰𐑐𐑦𐑙-𐑛𐑮𐑨𐑓𐑑
sleeping-draughts	𐑕𐑤𐑰𐑐𐑦𐑙-𐑛𐑮𐑨𐑓𐑑𐑕
snap-fastener	𐑕𐑯𐑨𐑐-𐑓𐑨𐑕𐑩𐑯𐑼
snap-fasteners	𐑕𐑯𐑨𐑐-𐑓𐑨𐑕𐑩𐑯𐑼𐑟
soprano	𐑕𐑩𐑐𐑮𐑨𐑯𐑴
sopranos	𐑕𐑩𐑐𐑮𐑨𐑯𐑴𐑟
spacecraft	𐑕𐑐𐑱𐑕𐑒𐑮𐑨𐑓𐑑
spyglass	𐑕𐑐𐑲𐑜𐑤𐑨𐑕
spyglasses	𐑕𐑐𐑲𐑜𐑤𐑨𐑕𐑩𐑟
staff	𐑕𐑑𐑨𐑓
staff-office	𐑕𐑑𐑨𐑓-𐑪𐑓𐑦𐑕
staff-offices	𐑕𐑑𐑨𐑓-𐑪𐑓𐑦𐑕𐑩𐑟
staffed	𐑕𐑑𐑨𐑓𐑑
staffing	𐑕𐑑𐑨𐑓𐑦𐑙
staffroom	𐑕𐑑𐑨𐑓𐑮𐑵𐑥
staffrooms	𐑕𐑑𐑨𐑓𐑮𐑵𐑥𐑟
staffs	𐑕𐑑𐑨𐑓𐑕
stagecraft	𐑕𐑑𐑱𐑡𐑒𐑮𐑨𐑓𐑑
stagecrafts	𐑕𐑑𐑱𐑡𐑒𐑮𐑨𐑓𐑑𐑕
statecraft	𐑕𐑑𐑱𐑑𐑒𐑮𐑨𐑓𐑑
stationmaster	𐑕𐑑𐑱𐑖𐑩𐑯𐑥𐑨𐑕𐑑𐑼
stationmasters	𐑕𐑑𐑱𐑖𐑩𐑯𐑥𐑨𐑕𐑑𐑼𐑟
steadfast	𐑕𐑑𐑧𐑛𐑓𐑨𐑕𐑑
steadfastly	𐑕𐑑𐑧𐑛𐑓𐑨𐑕𐑑𐑤𐑦
steadfastness	𐑕𐑑𐑧𐑛𐑓𐑨𐑕𐑑𐑯𐑩𐑕
sticking-plaster	𐑕𐑑𐑦𐑒𐑦𐑙-𐑐𐑤𐑨𐑕𐑑𐑼
sticking-plasters	𐑕𐑑𐑦𐑒𐑦𐑙-𐑐𐑤𐑨𐑕𐑑𐑼𐑟
strata	𐑕𐑑𐑮𐑨𐑑𐑩
stratum	𐑕𐑑𐑮𐑨𐑑𐑩𐑥
substrata	𐑕𐑳𐑚𐑕𐑑𐑮𐑨𐑑𐑩
substratum	𐑕𐑳𐑚𐑕𐑑𐑮𐑨𐑑𐑩𐑥
sultana	𐑕𐑳𐑤𐑑𐑨𐑯𐑩
sultanas	𐑕𐑳𐑤𐑑𐑨𐑯𐑩𐑟
sunglasses	𐑕𐑳𐑯𐑜𐑤𐑨𐑕𐑩𐑟
supplant	𐑕𐑩𐑐𐑤𐑨𐑯𐑑
supplanted	𐑕𐑩𐑐𐑤𐑨𐑯𐑑𐑩𐑛
supplanter	𐑕𐑩𐑐𐑤𐑨𐑯𐑑𐑼
supplanters	𐑕𐑩𐑐𐑤𐑨𐑯𐑑𐑼𐑟
supplanting	𐑕𐑩𐑐𐑤𐑨𐑯𐑑𐑦𐑙
supplants	𐑕𐑩𐑐𐑤𐑨𐑯𐑑𐑕
surpass	𐑕𐑼𐑐𐑨𐑕
surpassed	𐑕𐑼𐑐𐑨𐑕𐑑
surpasses	𐑕𐑼𐑐𐑨𐑕𐑩𐑟
surpassing	𐑕𐑼𐑐𐑨𐑕𐑦𐑙
surpassingly	𐑕𐑼𐑐𐑨𐑕𐑦𐑙𐑤𐑦
swimming-bath	𐑕𐑢𐑦𐑥𐑦𐑙-𐑚𐑨𐑔
swimming-baths	𐑕𐑢𐑦𐑥𐑦𐑙-𐑚𐑨𐑞𐑟
sword-dance	𐑕𐑹𐑛-𐑛𐑨𐑯𐑕
sword-dances	𐑕𐑹𐑛-𐑛𐑨𐑯𐑕𐑩𐑟
tap-dancing	𐑑𐑨𐑐-𐑛𐑨𐑯𐑕𐑦𐑙
task	𐑑𐑨𐑕𐑒
task-force	𐑑𐑨𐑕𐑒-𐑓𐑹𐑕
task-forces	𐑑𐑨𐑕𐑒-𐑓𐑹𐑕𐑩𐑟
tasked	𐑑𐑨𐑕𐑒𐑑
tasking	𐑑𐑨𐑕𐑒𐑦𐑙
taskmaster	𐑑𐑨𐑕𐑒𐑥𐑨𐑕𐑑𐑼
taskmasters	𐑑𐑨𐑕𐑒𐑥𐑨𐑕𐑑𐑼𐑟
tasks	𐑑𐑨𐑕𐑒𐑕
telecast	𐑑𐑧𐑤𐑦𐑒𐑨𐑕𐑑
telecasting	𐑑𐑧𐑤𐑦𐑒𐑨𐑕𐑑𐑦𐑙
telecasts	𐑑𐑧𐑤𐑦𐑒𐑨𐑕𐑑𐑕
thereafter	𐑞𐑺𐑨𐑓𐑑𐑼
thereinafter	𐑞𐑺𐑦𐑯𐑨𐑓𐑑𐑼
tightcast	𐑑𐑲𐑑𐑒𐑨𐑕𐑑
tipstaff	𐑑𐑦𐑐𐑕𐑑𐑨𐑓
tipstaffs	𐑑𐑦𐑐𐑕𐑑𐑨𐑓𐑕
toastmaster	𐑑𐑴𐑕𐑑𐑥𐑨𐑕𐑑𐑼
toastmasters	𐑑𐑴𐑕𐑑𐑥𐑨𐑕𐑑𐑼𐑟
topmast	𐑑𐑪𐑐𐑥𐑨𐑕𐑑
topmasts	𐑑𐑪𐑐𐑥𐑨𐑕𐑑𐑕
towing-path	𐑑𐑴𐑦𐑙-𐑐𐑨𐑔
towing-paths	𐑑𐑴𐑦𐑙-𐑐𐑨𐑞𐑟
towpath	𐑑𐑴𐑐𐑨𐑔
towpaths	𐑑𐑴𐑐𐑨𐑞𐑟
trance	𐑑𐑮𐑨𐑯𐑕
trances	𐑑𐑮𐑨𐑯𐑕𐑩𐑟
transplant	𐑑𐑮𐑨𐑯𐑕𐑐𐑤𐑨𐑯𐑑
transplantation	𐑑𐑮𐑨𐑯𐑕𐑐𐑤𐑨𐑯𐑑𐑱𐑖𐑩𐑯
transplantations	𐑑𐑮𐑨𐑯𐑕𐑐𐑤𐑨𐑯𐑑𐑱𐑖𐑩𐑯𐑟
transplanted	𐑑𐑮𐑨𐑯𐑕𐑐𐑤𐑨𐑯𐑑𐑩𐑛
transplanting	𐑑𐑮𐑨𐑯𐑕𐑐𐑤𐑨𐑯𐑑𐑦𐑙
transplants	𐑑𐑮𐑨𐑯𐑕𐑐𐑤𐑨𐑯𐑑𐑕
typecast	𐑑𐑲𐑐𐑒𐑨𐑕𐑑
typecasting	𐑑𐑲𐑐𐑒𐑨𐑕𐑑𐑦𐑙
typecasts	𐑑𐑲𐑐𐑒𐑨𐑕𐑑𐑕
unanswerable	𐑳𐑯𐑨𐑯𐑕𐑼𐑩𐑚𐑩𐑤
unanswered	𐑳𐑯𐑨𐑯𐑕𐑼𐑛
unasked	𐑳𐑯𐑨𐑕𐑒𐑑
undemanding	𐑳𐑯𐑛𐑦𐑥𐑨𐑯𐑛𐑦𐑙
underclass	𐑳𐑯𐑛𐑼𐑒𐑤𐑨𐑕
underpass	𐑳𐑯𐑛𐑼𐑐𐑨𐑕
underpasses	𐑳𐑯𐑛𐑼𐑐𐑨𐑕𐑩𐑟
understaffed	𐑳𐑯𐑛𐑼𐑕𐑑𐑨𐑓𐑑
unexampled	𐑳𐑯𐑦𐑜𐑟𐑨𐑥𐑐𐑩𐑤𐑛
unfasten	𐑳𐑯𐑓𐑨𐑕𐑩𐑯
unfastened	𐑳𐑯𐑓𐑨𐑕𐑩𐑯𐑛
unfastening	𐑳𐑯𐑓𐑨𐑕𐑩𐑯𐑦𐑙
unfastens	𐑳𐑯𐑓𐑨𐑕𐑩𐑯𐑟
unmask	𐑳𐑯𐑥𐑨𐑕𐑒
unmasked	𐑳𐑯𐑥𐑨𐑕𐑒𐑑
unmasking	𐑳𐑯𐑥𐑨𐑕𐑒𐑦𐑙
unmasks	𐑳𐑯𐑥𐑨𐑕𐑒𐑕
unsurpassed	𐑳𐑯𐑕𐑼𐑐𐑨𐑕𐑑
vantage	𐑝𐑨𐑯𐑑𐑦𐑡
vantage-point	𐑝𐑨𐑯𐑑𐑦𐑡-𐑐𐑶𐑯𐑑
vantage-points	𐑝𐑨𐑯𐑑𐑦𐑡-𐑐𐑶𐑯𐑑𐑕
vantages	𐑝𐑨𐑯𐑑𐑦𐑡𐑩𐑟
vapour-bath	𐑝𐑱𐑐𐑼-𐑚𐑨𐑔
vapour-baths	𐑝𐑱𐑐𐑼-𐑚𐑨𐑞𐑟
vast	𐑝𐑨𐑕𐑑
vastly	𐑝𐑨𐑕𐑑𐑤𐑦
vastness	𐑝𐑨𐑕𐑑𐑯𐑩𐑕
victoriana	𐑝𐑦𐑒𐑑𐑹𐑦𐑨𐑯𐑩
war-dance	𐑢𐑹-𐑛𐑨𐑯𐑕
war-dances	𐑢𐑹-𐑛𐑨𐑯𐑕𐑩𐑟
warpath	𐑢𐑹𐑐𐑨𐑔
warpaths	𐑢𐑹𐑐𐑨𐑞𐑟
waste-paper-basket	𐑢𐑱𐑕𐑑-𐑐𐑱𐑐𐑼-𐑚𐑨𐑕𐑒𐑩𐑑
waste-paper-baskets	𐑢𐑱𐑕𐑑-𐑐𐑱𐑐𐑼-𐑚𐑨𐑕𐑒𐑩𐑑𐑕
wastebasket	𐑢𐑱𐑕𐑑𐑚𐑨𐑕𐑒𐑩𐑑
wastebaskets	𐑢𐑱𐑕𐑑𐑚𐑨𐑕𐑒𐑩𐑑𐑕
watch-glass	𐑢𐑪𐑗-𐑜𐑤𐑨𐑕
watch-glasses	𐑢𐑪𐑗-𐑜𐑤𐑨𐑕𐑩𐑟
water-glass	𐑢𐑷𐑑𐑼-𐑜𐑤𐑨𐑕
wax-chandler	𐑢𐑨𐑒𐑕-𐑗𐑨𐑯𐑛𐑤𐑼
wax-chandlers	𐑢𐑨𐑒𐑕-𐑗𐑨𐑯𐑛𐑤𐑼𐑟
weather-glass	𐑢𐑧𐑞𐑼-𐑜𐑤𐑨𐑕
weather-glasses	𐑢𐑧𐑞𐑼-𐑜𐑤𐑨𐑕𐑩𐑟
wineglass	𐑢𐑲𐑯-𐑜𐑤𐑨𐑕
wineglasses	𐑢𐑲𐑯-𐑜𐑤𐑨𐑕𐑩𐑟
wing-commander	𐑢𐑦𐑙-𐑒𐑩𐑥𐑨𐑯𐑛𐑼
wing-commanders	𐑢𐑦𐑙-𐑒𐑩𐑥𐑨𐑯𐑛𐑼𐑟
witchcraft	𐑢𐑦𐑗𐑒𐑮𐑨𐑓𐑑
woodcraft	𐑢𐑫𐑛𐑒𐑮𐑨𐑓𐑑
woodcrafts	𐑢𐑫𐑛𐑒𐑮𐑨𐑓𐑑𐑕
workbasket	𐑢𐑻𐑒𐑚𐑨𐑕𐑒𐑩𐑑
workbaskets	𐑢𐑻𐑒𐑚𐑨𐑕𐑒𐑩𐑑𐑕
working-class	𐑢𐑻𐑒𐑦𐑙-𐑒𐑤𐑨𐑕
wormcast	𐑢𐑻𐑥𐑒𐑨𐑕𐑑
wormcasts	𐑢𐑻𐑥𐑒𐑨𐑕𐑑𐑕
zip-fastener	𐑟𐑦𐑐-𐑓𐑨𐑕𐑩𐑯𐑼
zip-fasteners	𐑟𐑦𐑐-𐑓𐑨𐑕𐑩𐑯𐑼𐑟
